日	ひ
日本	に ほん
日曜日	にち よう び
三日	みっ か
月	つき
月曜日	げつ よう び
一月	いち がつ
一か月	いっ か げつ
木	き
木曜日	もく よう び
木村	き むら
山	やま
富士山	ふ じ さん
山下	やま した
火山	か ざん
川	かわ
ナイル川	ナイル かわ
田んぼ	た んぼ
山田	やまだ
水田	すい でん
田中	た なか
人	ひと
三人	さん にん
日本人	に ほん じん
口	くち
入口	いり ぐち
出口	で ぐち
人口	じん こう
車	くるま
自動車	し どう しゃ
電車	でん しゃ
門	もん
専門	せん もん
火	ひ
火曜日	か よう び
水	みず
水曜日	すい よう よび
お金	お かね
金	きん
金田	かね だ
金曜日	きん よう び
土	つち
土曜日	ど よう び
土木	ど ぼく
子ども	こ ども
女子学生	じょ し がく せい
女の子	おんな の こ
女	おんな
彼女	かの じょ
女の人	おんな の ひと
学生	がく せい
学校	がっ こう
大学	だい がく
生きる	い きる
生まれる	う まれる
先生	せん せい
先	さき
先月	せん げつ
私	わたし
私立大学	し りつ だい がく
一つ	ひと つ
一人	ひと り
一年	いち ねん
二つ	ふた つ
二月	に がつ
二人	ふた り
二年	に ねん
二年間	に ねん かん
三つ	みっ つ
三月	さん がつ
三年	さん ねん
四つ	よっ つ
四月	し がつ
四日	よっ か
四年	よ ねん
四人	よ にん
五つ	いつ つ
五月	ご がつ
五日	いつ か
五年	ご ねん
五人	ご にん
六つ	むっ つ
六月	ろく がつ
六日	むい か
六年	ろく ねん
七つ	なな つ
七月	なな がつ
七日	なの か
七年	しち ねん
七人	しち にん
八つ	やっ つ
八月	はち がつ
八百	はっ ぴゃく
八日	よう か
八年	はち ねん
八人	はち にん
九つ	ここの つ
九月	く がつ
九日	ここの か
九百	きぃう ひゃく
九人	きゅう にん
十	とお
十月	じゅう がつ
十日	とお か
十年	じゅう ねん
二百	に ひゃく
六百	ろっ ぴゃく
三百	さん びゃく
千円	せん えん
三千	さん ぜん
千葉	ち ば
一万円	いち まん えん
万国	ばん こく
万歳	ばん ざい
円	えん
五千円	ご せん えん
百円	ひゃく えん
年上	とし うえ
去年	きょ ねん
来年	らい ねん
今年	こと し
上	うえ
上る	のぼ る
上げる	あ げる
上手	じょう ず
下	した
年下	とし した
下がる	さ がる
下車する	げ しゃ する
中	なか
一日中	いち にち じゅう
中心	ちゅう しん
大きい	おお きい
大切な	たい せつ な
大人	お とな
小さい	ちい さい
小学校	しょう がっ こう
小人	こ ども
小川	お がわ
山本	やま もと
本日	ほん じつ
本	ほん
本店	ほん てん
半ば	なか ば
半年	はん とし
半分	はん ぶん
三時半	さん じ はん
分ける	わ ける
五分	ご ふん
分かる	わ かる
六分	ろく ぶん
力	ちから
力学	りき がく
実力	じつ りょく
何	なに
何人	なん にん
何ですか	なん ですか
何年	なん ねん
